start,end,Mon,Tue,Wed,Thu,Fri,Sat,Sun
0,3600,10,8,9,10,30,17,20
3600,7200,2,2,2,1,6,4,4
7200,18000,9,11,11,9,27,15,18
18000,21600,2,2,2,1,6,4,4
21600,25200,9,7,7,6,27,15,18
25200,32400,9,11,11,12,27,15,18
32400,36000,-10,-8,-9,-10,-30,-17,-20
36000,39600,-2,-2,-2,-1,-6,-4,-4
39600,50400,-9,-11,-11,-9,-27,-15,-18
50400,54000,-2,-2,-2,-1,-6,-4,-4
54000,57600,-9,-7,-7,-6,-27,-15,-18
