start,end,Mon,Tue,Wed,Thu,Fri,Sat,Sun
0,3600,25,13,20,22,100,50,75
3600,7200,8,9,5,5,32,16,24
7200,18000,1,6,5,6,4,2,3
18000,21600,23,23,21,18,92,46,69
21600,25200,0,8,8,8,0,0,0
25200,32400,14,13,11,11,56,28,42
32400,36000,-25,-13,-20,-22,-100,-50,-75
36000,39600,-8,-9,-5,-5,-32,-16,-24
39600,50400,-1,-6,-5,-6,-4,-2,-3
50400,54000,-23,-23,-21,-18,-92,-46,-69
54000,57600,0,-8,-8,-8,0,0,0
